                  MAP
|---------------------------------------|
|  Montagne |      Foret      |         |
|----------------|            |         |
|  Rivière       |            |         |
|------------|   |------------| Désert  |
|            |   |            |         |
|   Marais   |   |   Plaine   |         |
|            |   |            |         |
|---------------------------------------|
